krank	Adjective	44 minutes ago	
Formular	Noun	44 minutes ago	
Formulare	Noun	44 minutes ago	
Krankheit	Noun	44 minutes ago	
Alkohol	Noun	51 minutes ago	
komplett	Adjective	18 hours ago	
tatsächlich	Adjective	18 hours ago	
zu	Adverb	18 hours ago	
ausgezeichnet	Adjective	18 hours ago	
heiße	Adjective	18 hours ago	
echt	Adjective	18 hours ago	
noch	Adverb	18 hours ago	
immer	Adverb	18 hours ago	
automatisch	Adjective	18 hours ago	
auch	Adverb	18 hours ago	
genug	Adverb	18 hours ago	
selbstverständlich	Adjective	yesterday	
unmöglich	Adjective	yesterday	
notwendig	Adjective	yesterday	
möglich	Adjective	yesterday	
deutlich	Adjective	yesterday	
unbekannt	Adjective	yesterday	
verfügbar	Adjective	yesterday	
unabhängig	Adjective	yesterday	
bekannt	Adjective	yesterday	
Gäste	Noun	yesterday	
Hof	Noun	yesterday	
Vornamen	Noun	yesterday	
Vorname	Noun	yesterday	
Höfe	Noun	yesterday	
mich	Pronoun	3 days ago	
sauber	Adjective	3 days ago	
euch	Pronoun	3 days ago	
schmutzig	Adjective	3 days ago	
dieses	Pronoun	3 days ago	
gehe	Verb	3 days ago	
scheint	Verb	3 days ago	
kein	Determiner	3 days ago	
keinen	Determiner	3 days ago	
keine ahnung		4 days ago	
Beziehungen	Noun	4 days ago	
Geschwister	Noun	4 days ago	
Familien	Noun	4 days ago	
Großmutter	Noun	4 days ago	
gehen	Verb	6 days ago	
wahrscheinlich	Adjective	6 days ago	
kostenlos	Adjective	6 days ago	
gratis	Adverb	6 days ago	
zufrieden	Adjective	6 days ago	
positiv	Adjective	6 days ago	
verpflichtet	Adjective	6 days ago	
sichtbar	Adjective	6 days ago	
begeistert	Adjective	6 days ago	
klar	Adjective	6 days ago	
eindeutig	Adjective	6 days ago	
individuell	Adjective	6 days ago	
gegenüber	Preposition	6 days ago	
Ferienhaus	Noun	6 days ago	
Ferienhäuser	Noun	6 days ago	
Ort	Noun	6 days ago	
Zentrum	Noun	6 days ago	
drinnen	Adverb	6 days ago	
nebenan	Adverb	6 days ago	
innen	Adverb	6 days ago	
hinten	Adverb	6 days ago	
vorne	Adverb	6 days ago	
draußen	Adverb	6 days ago	
meine	Pronoun	6 days ago	
unten	Adverb	6 days ago	
bereit	Adjective	1 week ago	
genau	Adjective	1 week ago	
komisch	Adjective	1 week ago	
plötzlich	Adjective	1 week ago	
regional	Adjective	1 week ago	
sinnvoll	Adjective	1 week ago	
zuständig	Adjective	1 week ago	
wert	Adjective	1 week ago	
nützlich	Adjective	1 week ago	
praktisch	Adjective	1 week ago	
unsichtbar	Adjective	1 week ago	
persönlich	Adjective	1 week ago	
international	Adjective	1 week ago	
lass	Verb	1 week ago	
Innere	Noun	1 week ago	
europa	Proper noun	1 week ago	
Regionen	Noun	1 week ago	
Kinder	Noun	1 week ago	
sind	Verb	1 week ago	
seid	Verb	1 week ago	
Frauen	Noun	1 week ago	
Männer	Noun	1 week ago	
wir	Pronoun	1 week ago	
Jungen	Noun	1 week ago	
schwimmen	Verb	1 week ago	
Sofa	Noun	2 weeks ago	
abhängig	Adjective	2 weeks ago	
Erde	Noun	2 weeks ago	
Sonne	Noun	2 weeks ago	
Stern	Noun	2 weeks ago	
Standort	Noun	2 weeks ago	
Fläche	Noun	2 weeks ago	
falsch	Adjective	2 weeks ago	
lustig	Adjective	2 weeks ago	
weich	Adjective	2 weeks ago	
offen	Adjective	2 weeks ago	
extrem	Adjective	2 weeks ago	
Bezirk	Noun	2 weeks ago	
Flughafen	Noun	2 weeks ago	
Inseln	Noun	2 weeks ago	
Insel	Noun	2 weeks ago	
Grundstück	Noun	2 weeks ago	
Buch	Noun	2 weeks ago	
ein	Determiner	2 weeks ago	
hat	Verb	2 weeks ago	
haben	Verb	2 weeks ago	
habe	Verb	2 weeks ago	
seltsam	Adjective	3 weeks ago	
allgemein	Adjective	3 weeks ago	
relativ	Adjective	3 weeks ago	
egal	Adjective	3 weeks ago	
aktiv	Adjective	3 weeks ago	
sehr	Adverb	3 weeks ago	
handle	Verb	3 weeks ago	
nimm	Verb	3 weeks ago	
Kind	Noun	3 weeks ago	
ist	Verb	3 weeks ago	
Mädchen	Noun	3 weeks ago	
er	Pronoun	3 weeks ago	
es	Pronoun	3 weeks ago	
Brot	Noun	3 weeks ago	
du	Pronoun	3 weeks ago	
trinkt	Verb	3 weeks ago	
bist	Verb	3 weeks ago	
und	Conjunction	3 weeks ago	
Zentrale	Noun	3 weeks ago	
Pension	Noun	3 weeks ago	
Bereich	Noun	3 weeks ago	
überall	Adverb	3 weeks ago	
Halle	Noun	3 weeks ago	
verantwortlich	Adjective	3 weeks ago	
privat	Adjective	3 weeks ago	
knapp	Adjective	3 weeks ago	
gemeinsam	Adjective	3 weeks ago	
hart	Adjective	3 weeks ago	
langsamer	Adjective	3 weeks ago	
als	Conjunction	3 weeks ago	
teurer	Adjective	3 weeks ago	
größer	Adjective	3 weeks ago	
leichter	Adjective	3 weeks ago	
schneller	Adjective	3 weeks ago	
das	Determiner	3 weeks ago	
die	Determiner	3 weeks ago	
Apotheke	Noun	3 weeks ago	
Apotheken	Noun	3 weeks ago	
Marktplatz	Noun	3 weeks ago	
Gutscheine	Noun	3 weeks ago	
alt	Adjective	4 weeks ago	
langsam	Adjective	4 weeks ago	
Vögel	Noun	4 weeks ago	
schnell	Adjective	4 weeks ago	
hoch	Adjective	4 weeks ago	
Ausland	Noun	4 weeks ago	
alles klar		4 weeks ago	
kurz	Adjective	4 weeks ago	
sei	Verb	4 weeks ago	
rufe	Verb	4 weeks ago	
lies	Verb	4 weeks ago	
Bundesland	Noun	4 weeks ago	
kaputt	Adjective	4 weeks ago	
beliebt	Adjective	4 weeks ago	
schreiben	Verb	1 month ago	
schlafe	Verb	1 month ago	
schwer	Adjective	1 month ago	
original	Adjective	1 month ago	
fest	Adjective	1 month ago	
hilfreich	Adjective	1 month ago	
fit	Adjective	1 month ago	
geht	Verb	1 month ago	
geh	Verb	1 month ago	
Obst	Noun	1 month ago	
gut	Adjective	1 month ago	
aus	Preposition	1 month ago	
das	Pronoun	1 month ago	
gute nacht		1 month ago	
Hunger	Noun	1 month ago	
Bier	Noun	1 month ago	
fertig	Adjective	1 month ago	
außen	Adverb	1 month ago	
hier	Adverb	1 month ago	
oben	Adverb	1 month ago	
hallo	Interjection	1 month ago	
in ordnung		1 month ago	
willkommen	Adjective	1 month ago	
bin	Verb	1 month ago	
ja	Adverb	1 month ago	
Junge	Noun	1 month ago	
Mann	Noun	1 month ago	
bitte	Adverb	1 month ago	
ich	Pronoun	1 month ago	
eine	Determiner	1 month ago	
nein	Adverb	1 month ago	
es tut mir leid		1 month ago	
tschüss	Interjection	1 month ago	
Frau	Noun	1 month ago	
gern geschehen		1 month ago	
danke	Interjection	1 month ago	
salzig	Adjective	1 month ago	
zu mittag		1 month ago	
drüben	Adverb	1 month ago	
da	Adverb	1 month ago	
dort	Adverb	1 month ago	
ruf	Verb	1 month ago	
großen	Adjective	1 month ago	
kleinen	Adjective	1 month ago	
besser	Adjective	1 month ago	
stärker	Adjective	1 month ago	
schöner	Adjective	1 month ago	
länger	Adjective	1 month ago	
wichtiger	Adjective	1 month ago	
höher	Adjective	1 month ago	
kleiner	Adjective	1 month ago	
täglich	Adjective	1 month ago	
bald	Adverb	1 month ago	
Vergangenheit	Noun	1 month ago	
Samstage	Noun	1 month ago	
Sonntage	Noun	1 month ago	
danach	Adverb	1 month ago	
spätestens	Adverb	1 month ago	
inzwischen	Adverb	1 month ago	
wöchentlich	Adjective	1 month ago	
Woche	Noun	1 month ago	
Wochen	Noun	1 month ago	
gewöhnlich	Adjective	1 month ago	
ziemlich	Adverb	1 month ago	
ganz	Adverb	1 month ago	
super	Adjective	1 month ago	
normalerweise	Adverb	1 month ago	
gute	Adjective	1 month ago	
eher	Adverb	1 month ago	
Papier	Noun	1 month ago	
Leder	Noun	1 month ago	
beste	Adjective	1 month ago	
Gold	Noun	1 month ago	
Bahn	Noun	1 month ago	
italien	Proper noun	1 month ago	
Besuch	Noun	1 month ago	
Glas	Noun	1 month ago	
am	Preposition	1 month ago	
während	Preposition	1 month ago	
einschließlich	Preposition	1 month ago	
aufs	Preposition	1 month ago	
im	Preposition	1 month ago	
ums	Preposition	1 month ago	
legt	Verb	1 month ago	
Toiletten	Noun	1 month ago	
Leiter	Noun	1 month ago	
Schlaf	Noun	1 month ago	
Batterie	Noun	1 month ago	
leer	Adjective	1 month ago	
Fahrrad	Noun	1 month ago	
ähnlich	Adjective	1 month ago	
ersten	Adjective	1 month ago	
Feuerwehr	Noun	1 month ago	
Professor	Noun	1 month ago	
Bäckerin	Noun	1 month ago	
Professorin	Noun	1 month ago	
Arbeitnehmer	Noun	1 month ago	
Beruf	Noun	1 month ago	
Bauer	Noun	1 month ago	
Autor	Noun	1 month ago	
Ärzte	Noun	1 month ago	
Lehrerin	Noun	1 month ago	
schwarz	Adjective	1 month ago	
grau	Adjective	1 month ago	
grün	Adjective	1 month ago	
braun	Adjective	1 month ago	
Farbe	Noun	1 month ago	
pink	Adjective	1 month ago	
roter	Adjective	1 month ago	
grüne	Adjective	1 month ago	
rotes	Adjective	1 month ago	
gelb	Adjective	1 month ago	
bunt	Adjective	1 month ago	
blau	Adjective	1 month ago	
rot	Adjective	1 month ago	
roten	Adjective	1 month ago	
weißen	Adjective	1 month ago	
vierundzwanzig	Numeral	1 month ago	
zwanzig	Numeral	1 month ago	
fünfzig	Numeral	1 month ago	
tausend	Numeral	1 month ago	
hundertdreiundzwanzig	Numeral	1 month ago	
dreiundzwanzig	Numeral	1 month ago	
zweiundachtzig	Numeral	1 month ago	
hundert	Numeral	1 month ago	
Milliarden	Noun	1 month ago	
Meter	Noun	1 month ago	
siebzig	Numeral	1 month ago	
achtzig	Numeral	1 month ago	
neunzig	Numeral	1 month ago	
zweiunddreißig	Numeral	1 month ago	
vierzig	Numeral	1 month ago	
zweiundvierzig	Numeral	1 month ago	
dreißig	Numeral	1 month ago	
Millionen	Noun	1 month ago	
Million	Noun	1 month ago	
billig	Adjective	1 month ago	
verkauft	Verb	1 month ago	
irgendwie	Adverb	1 month ago	
dich	Pronoun	1 month ago	
irgendwas	Determiner	1 month ago	
irgendwann	Adverb	1 month ago	
irgendwo	Adverb	1 month ago	
irgendwer	Determiner	1 month ago	
mir	Pronoun	1 month ago	
uns	Pronoun	1 month ago	
ihr	Pronoun	1 month ago	
meinem	Pronoun	1 month ago	
meinen	Pronoun	1 month ago	
ihm	Pronoun	1 month ago	
gehörst	Verb	1 month ago	
gehören	Verb	1 month ago	
meiner	Pronoun	1 month ago	
schweizer franken		1 month ago	
ihnen	Pronoun	1 month ago	
dir	Pronoun	1 month ago	
Preise	Noun	1 month ago	
Euro	Noun	1 month ago	
Euros	Noun	1 month ago	
Cent	Noun	1 month ago	
toll	Adjective	1 month ago	
normal	Adjective	1 month ago	
schlecht	Adjective	1 month ago	
frei	Adjective	1 month ago	
leicht	Adjective	1 month ago	
perfekt	Adjective	1 month ago	
Finger	Noun	1 month ago	
Herzen	Noun	1 month ago	
Haare	Noun	1 month ago	
Hände	Noun	1 month ago	
Köpfe	Noun	1 month ago	
Auge	Noun	1 month ago	
Haut	Noun	1 month ago	
zu abend		1 month ago	
Messer	Noun	1 month ago	
scharf	Adjective	1 month ago	
Salat	Noun	1 month ago	
süß	Adjective	1 month ago	
sauer	Adjective	1 month ago	
von	Preposition	1 month ago	
zum	Preposition	1 month ago	
zur	Preposition	1 month ago	
vom	Preposition	1 month ago	
bei	Preposition	1 month ago	
seit	Preposition	1 month ago	
nach	Preposition	1 month ago	
zu	Preposition	1 month ago	
Schwein	Noun	1 month ago	
Bär	Noun	1 month ago	
kauft	Verb	1 month ago	
Marmelade	Noun	1 month ago	
reich	Adjective	1 month ago	
wie viel		1 month ago	
wie viele		1 month ago	
wie bitte		1 month ago	
wie	Conjunction	1 month ago	
schwanger	Adjective	1 month ago	
Partnerschaft	Noun	1 month ago	
worüber	Adverb	1 month ago	
warum	Adverb	1 month ago	
womit	Adverb	1 month ago	
wofür	Adverb	1 month ago	
wieso	Adverb	1 month ago	
wohin	Adverb	1 month ago	
woher	Adverb	1 month ago	
wo	Adverb	1 month ago	
wann	Adverb	1 month ago	
einem	Determiner	1 month ago	
den	Determiner	1 month ago	
dem	Determiner	1 month ago	
einer	Determiner	1 month ago	
zeigt	Verb	1 month ago	
vier	Numeral	1 month ago	
zwei	Numeral	1 month ago	
siebzehn	Numeral	1 month ago	
neunzehn	Numeral	1 month ago	
fünf	Numeral	1 month ago	
eins	Numeral	1 month ago	
es gibt		1 month ago	
sechzehn	Numeral	1 month ago	
drei	Numeral	1 month ago	
Zahlen	Noun	1 month ago	
Zahl	Noun	1 month ago	
ohne	Preposition	1 month ago	
durch	Preposition	1 month ago	
um	Preposition	1 month ago	
zehn	Numeral	1 month ago	
neun	Numeral	1 month ago	
für	Preposition	1 month ago	
sechs	Numeral	1 month ago	
vierzehn	Numeral	1 month ago	
acht	Numeral	1 month ago	
gegen	Preposition	1 month ago	
sieben	Numeral	1 month ago	
Nummer	Noun	1 month ago	
vielleicht	Adverb	1 month ago	
wieder	Adverb	1 month ago	
zusammen	Adverb	1 month ago	
alleine	Adverb	1 month ago	
dran	Adverb	1 month ago	
schon	Adverb	1 month ago	
nur	Adverb	1 month ago	
genau		2 months ago	
auf wiedersehen		2 months ago	
leider	Adverb	2 months ago	
bis bald		2 months ago	
bis später		2 months ago	
bis morgen		2 months ago	
gerne	Adverb	2 months ago	
gern	Adverb	2 months ago	
wirklich	Adjective	2 months ago	
so	Adverb	2 months ago	
guten tag		2 months ago	
wie geht's		2 months ago	
mir geht's gut		2 months ago	
guten morgen		2 months ago	
guten abend		2 months ago	
Schwester	Noun	2 months ago	
Schwestern	Noun	2 months ago	
Brüder	Noun	2 months ago	
Fenster	Noun	2 months ago	
Treppe	Noun	2 months ago	
Dach	Noun	2 months ago	
öffnet	Verb	2 months ago	
trägst	Verb	2 months ago	
nicht	Adverb	2 months ago	
rund	Adjective	2 months ago	
groß	Adjective	2 months ago	
ruhig	Adjective	2 months ago	
klein	Adjective	2 months ago	
lang	Adjective	2 months ago	
stark	Adjective	2 months ago	
laut	Adjective	2 months ago	
leise	Adjective	2 months ago	
schwach	Adjective	2 months ago	
Enten	Noun	2 months ago	
Bären	Noun	2 months ago	
Kühe	Noun	2 months ago	
Mäuse	Noun	2 months ago	
obwohl	Conjunction	2 months ago	
solange	Conjunction	2 months ago	
denn	Conjunction	2 months ago	
entweder	Conjunction	2 months ago	
da	Conjunction	2 months ago	
oder	Conjunction	2 months ago	
sobald	Conjunction	2 months ago	
aber	Conjunction	2 months ago	
weil	Conjunction	2 months ago	
sondern	Conjunction	2 months ago	
Gruppen	Noun	2 months ago	
Damen	Noun	2 months ago	
Herren	Noun	2 months ago	
Herr	Noun	2 months ago	
Gegner	Noun	2 months ago	
sie	Pronoun	2 months ago	
das		2 months ago	
ihren	Pronoun	2 months ago	
euren	Pronoun	2 months ago	
Zeug	Noun	2 months ago	
ihn	Pronoun	2 months ago	
Werkzeug	Noun	2 months ago	
Fahrzeug	Noun	2 months ago	
Fahrzeuge	Noun	2 months ago	
Werkzeuge	Noun	2 months ago	
Straße	Noun	2 months ago	
Brücke	Noun	2 months ago	
Bibliothek	Noun	2 months ago	
Restaurants	Noun	2 months ago	
Häuser	Noun	2 months ago	
nie	Adverb	2 months ago	
keine	Determiner	2 months ago	
keiner	Determiner	2 months ago	
niemals	Adverb	2 months ago	
paar	Determiner	2 months ago	
viel	Determiner	2 months ago	
jemand	Determiner	2 months ago	
alles	Determiner	2 months ago	
niemand	Determiner	2 months ago	
beide	Determiner	2 months ago	
dein	Pronoun	2 months ago	
mein	Pronoun	2 months ago	
deine	Pronoun	2 months ago	
seine	Pronoun	2 months ago	
Luft	Noun	2 months ago	
Blume	Noun	2 months ago	
Feuer	Noun	2 months ago	
Berge	Noun	2 months ago	
mögen	Verb	2 months ago	
schwimmt	Verb	2 months ago	
bezahle	Verb	2 months ago	
braucht	Verb	2 months ago	
Englisch	Noun	2 months ago	
Deutsch	Noun	2 months ago	
hans	Proper noun	2 months ago	
bringe	Verb	2 months ago	
warm	Adjective	2 months ago	
wichtig	Adjective	2 months ago	
kalt	Adjective	2 months ago	
richtig	Adjective	2 months ago	
tief	Adjective	2 months ago	
jung	Adjective	2 months ago	
neu	Adjective	2 months ago	
müde	Adjective	2 months ago	
traurig	Adjective	2 months ago	
teuer	Adjective	2 months ago	
einfach	Adjective	2 months ago	
gesund	Adjective	2 months ago	
weit	Adjective	2 months ago	
schön	Adjective	2 months ago	
alle	Determiner	2 months ago	
Durst	Noun	2 months ago	
Eis	Noun	2 months ago	
frisch	Adjective	2 months ago	
lecker	Adjective	2 months ago	
Essen	Noun	2 months ago	
esst	Verb	2 months ago	
essen	Verb	2 months ago	
esse	Verb	2 months ago	
isst	Verb	2 months ago	
Zeitung	Noun	2 months ago	
einen	Determiner	2 months ago	
trinke	Verb	2 months ago	
Milch	Noun	2 months ago	
hast	Verb	2 months ago	
trinkst	Verb	2 months ago	
habt	Verb	2 months ago	
trinken	Verb	2 months ago	
Wasser	Noun	4 months ago	
Zucker	Noun	7 months ago	
Ei	Noun	7 months ago	
kommt	Verb	7 months ago	
Rot	Noun	10 months ago	
Arzt	Noun	10 months ago	
Busse	Noun	10 months ago	
Besucher	Noun	10 months ago	
Gast	Noun	10 months ago	
der	Determiner	10 months ago	
einundzwanzig	Numeral	10 months ago	
Prozent	Noun	10 months ago	
Name	Noun	10 months ago	
Namen	Noun	10 months ago	
achtundzwanzig	Numeral	10 months ago	
schwarzes	Adjective	10 months ago	
hinter	Preposition	10 months ago	
Erwachsene	Noun	10 months ago	
mit	Preposition	10 months ago	
deinen	Pronoun	10 months ago	
sagt	Verb	10 months ago	
Löffel	Noun	10 months ago	
ab	Preposition	10 months ago	
Augen	Noun	10 months ago	
Zitrone	Noun	10 months ago	
ihrer	Pronoun	10 months ago	
Vorspeise	Noun	10 months ago	
Anfänger	Noun	10 months ago	
bis	Preposition	10 months ago	
folge	Verb	10 months ago	
folgt	Verb	10 months ago	
vor	Preposition	10 months ago	
Haushaltsgeräte	Noun	10 months ago	
folgen	Verb	10 months ago	
Dutzend	Noun	10 months ago	
achtzehn	Numeral	10 months ago	
fünfzehn	Numeral	10 months ago	
diesen	Pronoun	10 months ago	
Stuhl	Noun	10 months ago	
Rezept	Noun	10 months ago	
großbritannien	Proper noun	10 months ago	
kenne	Verb	10 months ago	
kocht	Verb	10 months ago	
kochst	Verb	10 months ago	
kennen	Verb	10 months ago	
Senf	Noun	10 months ago	
Reinigung	Noun	10 months ago	
Kasse	Noun	10 months ago	
Telefonnummer	Noun	10 months ago	
voll	Adjective	10 months ago	
Bus	Noun	10 months ago	
wegen	Preposition	10 months ago	
endlich	Adverb	10 months ago	
Ende	Noun	10 months ago	
Maus	Noun	10 months ago	
lebe	Verb	10 months ago	
Tier	Noun	10 months ago	
elf	Numeral	10 months ago	
ins	Preposition	10 months ago	
Markt	Noun	10 months ago	
Märkte	Noun	10 months ago	
Autos	Noun	10 months ago	
gehst	Verb	10 months ago	
wasche	Verb	10 months ago	
waschen	Verb	10 months ago	
etwas	Pronoun	10 months ago	
Zimmer	Noun	10 months ago	
Ferien	Noun	10 months ago	
Verspätung	Noun	10 months ago	
Schweden	Noun	10 months ago	
Leitern	Noun	10 months ago	
Haushalt	Noun	10 months ago	
wenn	Conjunction	10 months ago	
Schlüssel	Noun	10 months ago	
Wand	Noun	10 months ago	
hilft	Verb	10 months ago	
Verkehr	Noun	10 months ago	
schläfst	Verb	10 months ago	
Reiseführer	Noun	10 months ago	
schläft	Verb	10 months ago	
weiß	Adjective	10 months ago	
Seife	Noun	10 months ago	
Hälfte	Noun	10 months ago	
dreizehn	Numeral	10 months ago	
Großeltern	Noun	10 months ago	
Summe	Noun	10 months ago	
zwölf	Numeral	10 months ago	
sechzig	Numeral	10 months ago	
Strecke	Noun	10 months ago	
Strecken	Noun	10 months ago	
Bürger	Noun	10 months ago	
beginnen	Verb	10 months ago	
Heizung	Noun	10 months ago	
Knöpfe	Noun	10 months ago	
läufst	Verb	10 months ago	
welchen	Determiner	10 months ago	
Abenteuer	Noun	10 months ago	
euer	Pronoun	10 months ago	
Publikum	Noun	10 months ago	
fahre	Verb	10 months ago	
spanien	Proper noun	10 months ago	
Architekten	Noun	10 months ago	
Architekt	Noun	10 months ago	
Schweine	Noun	10 months ago	
schreibt	Verb	10 months ago	
schreibst	Verb	10 months ago	
Bücher	Noun	10 months ago	
schreibe	Verb	10 months ago	
Zahnbürste	Noun	10 months ago	
Motorräder	Noun	10 months ago	
Blumen	Noun	10 months ago	
Meister	Noun	10 months ago	
kleines	Adjective	10 months ago	
Schweizer	Noun	10 months ago	
frankreich	Proper noun	10 months ago	
wandern	Verb	10 months ago	
Flasche	Noun	10 months ago	
Äpfel	Noun	10 months ago	
Flüge	Noun	10 months ago	
Nudeln	Noun	10 months ago	
Flug	Noun	10 months ago	
Fahrt	Noun	10 months ago	
bucht	Verb	10 months ago	
Fisch	Noun	10 months ago	
Stadtplan	Noun	10 months ago	
Pizza	Noun	10 months ago	
trägt	Verb	10 months ago	
Hut	Noun	10 months ago	
Schmuck	Noun	10 months ago	
guten	Adjective	10 months ago	
Pferd	Noun	10 months ago	
guter	Adjective	10 months ago	
Zug	Noun	10 months ago	
Küche	Noun	10 months ago	
Salz	Noun	10 months ago	
Urlaub	Noun	10 months ago	
Rasierer	Noun	10 months ago	
afrika	Proper noun	10 months ago	
hamburg	Proper noun	10 months ago	
bayern	Proper noun	10 months ago	
Weg	Noun	10 months ago	
dass	Conjunction	11 months ago	
machen	Verb	11 months ago	
mache	Verb	11 months ago	
reicht	Verb	11 months ago	
Boot	Noun	11 months ago	
wien	Proper noun	11 months ago	
österreich	Proper noun	11 months ago	
Saft	Noun	11 months ago	
sprichst	Verb	11 months ago	
heiße	Verb	11 months ago	
Fahrer	Noun	11 months ago	
renne	Verb	11 months ago	
deutschland	Proper noun	11 months ago	
rennst	Verb	11 months ago	
Lampe	Noun	11 months ago	
Kleidung	Noun	11 months ago	
denkt	Verb	11 months ago	
denkst	Verb	11 months ago	
Licht	Noun	11 months ago	
Baum	Noun	11 months ago	
bezahlen	Verb	11 months ago	
spiele	Verb	11 months ago	
Himmel	Noun	11 months ago	
spielst	Verb	11 months ago	
Mauer	Noun	11 months ago	
Teller	Noun	11 months ago	
Preis	Noun	11 months ago	
doch	Conjunction	11 months ago	
wessen	Pronoun	11 months ago	
kosten	Verb	11 months ago	
Nuss	Noun	11 months ago	
Nüsse	Noun	11 months ago	
Müsli	Noun	11 months ago	
beim	Preposition	11 months ago	
Schülerin	Noun	11 months ago	
Eltern	Noun	11 months ago	
Schülerinnen	Noun	11 months ago	
erstes	Adjective	11 months ago	
Freunde	Noun	11 months ago	
Arbeitgeberinnen	Noun	11 months ago	
Dorf	Noun	11 months ago	
Arbeitgeberin	Noun	11 months ago	
Tassen	Noun	11 months ago	
Tasse	Noun	11 months ago	
Senior	Noun	11 months ago	
Senioren	Noun	11 months ago	
Ärztin	Noun	11 months ago	
weiße	Adjective	11 months ago	
Tochter	Noun	11 months ago	
Töchter	Noun	11 months ago	
Bad	Noun	11 months ago	
welches	Determiner	11 months ago	
welche	Determiner	11 months ago	
Geschäftsführer	Noun	11 months ago	
Geldautomat	Noun	11 months ago	
Dollar	Noun	11 months ago	
unseren	Pronoun	11 months ago	
Füße	Noun	11 months ago	
sehe	Verb	11 months ago	
Rock	Noun	11 months ago	
siehst	Verb	11 months ago	
Menschen	Noun	11 months ago	
Mensch	Noun	11 months ago	
antwortet	Verb	11 months ago	
Koch	Noun	11 months ago	
Beine	Noun	11 months ago	
brauche	Verb	11 months ago	
Baby	Noun	11 months ago	
Leute	Noun	11 months ago	
schwarze	Adjective	11 months ago	
Metall	Noun	11 months ago	
Batterien	Noun	11 months ago	
große	Adjective	11 months ago	
Schüssel	Noun	11 months ago	
Gerät	Noun	11 months ago	
Berufe	Noun	11 months ago	
Spiegel	Noun	11 months ago	
Karton	Noun	11 months ago	
gutes	Adjective	11 months ago	
über	Preposition	11 months ago	
dieser	Pronoun	11 months ago	
Mittwoch	Noun	11 months ago	
Butter	Noun	11 months ago	
Stadt	Noun	11 months ago	
Handtuch	Noun	11 months ago	
bunte	Adjective	11 months ago	
kaufen	Verb	11 months ago	
Mitarbeiterin	Noun	11 months ago	
Mitarbeiter	Noun	11 months ago	
welcher	Determiner	11 months ago	
bessere	Adjective	11 months ago	
seinem	Pronoun	11 months ago	
grünen	Adjective	11 months ago	
unserem	Pronoun	11 months ago	
unserer	Pronoun	11 months ago	
beiden	Determiner	11 months ago	
Trainer	Noun	11 months ago	
vielen	Determiner	11 months ago	
Ohr	Noun	11 months ago	
Nasen	Noun	11 months ago	
deiner	Pronoun	11 months ago	
Chefin	Noun	11 months ago	
siebte	Verb	11 months ago	
legen	Verb	11 months ago	
Arbeitgeber	Noun	11 months ago	
verheiratet	Adjective	11 months ago	
Beton	Noun	11 months ago	
Verkäufer	Noun	11 months ago	
Hochzeit	Noun	11 months ago	
Pappe	Noun	11 months ago	
unter	Preposition	11 months ago	
Gläser	Noun	11 months ago	
Händler	Noun	11 months ago	
sechste	Adjective	11 months ago	
zwischen	Preposition	11 months ago	
Antworten	Noun	11 months ago	
Autoren	Noun	11 months ago	
blauen	Adjective	11 months ago	
besten	Adjective	11 months ago	
Söhne	Noun	11 months ago	
in	Preposition	11 months ago	
Wolle	Noun	11 months ago	
vierte	Adjective	12 months ago	
Arbeit	Noun	12 months ago	
an	Preposition	12 months ago	
Kupfer	Noun	12 months ago	
erste	Adjective	12 months ago	
auf	Preposition	1 year ago	
Schüler	Noun	1 year ago	
Speisekarte	Noun	1 year ago	
Mathematik	Noun	1 year ago	
Bedienung	Noun	1 year ago	
Köchinnen	Noun	1 year ago	
dritte	Adjective	1 year ago	
Bürgermeister	Noun	1 year ago	
Pilz	Noun	1 year ago	
Mittagessen	Noun	1 year ago	
Lehrer	Noun	1 year ago	
Kunden	Noun	1 year ago	
Kunde	Noun	1 year ago	
rote	Adjective	1 year ago	
weißes	Adjective	1 year ago	
Studentin	Noun	1 year ago	
Student	Noun	1 year ago	
Ring	Noun	1 year ago	
Einkaufszentrum	Noun	1 year ago	
Bäcker	Noun	1 year ago	
grauen	Adjective	1 year ago	
Hemd	Noun	1 year ago	
Hund	Noun	1 year ago	
Liter	Noun	1 year ago	
Tisch	Noun	1 year ago	
Sonderangebot	Noun	1 year ago	
Bäckerei	Noun	1 year ago	
Farben	Noun	1 year ago	
Reise	Noun	1 year ago	
Pass	Noun	1 year ago	
Tour	Noun	1 year ago	
schweiz	Proper noun	1 year ago	
Mietwagen	Noun	1 year ago	
Bushaltestelle	Noun	1 year ago	
Tourismus	Noun	1 year ago	
Sehenswürdigkeiten	Noun	1 year ago	
Motorrad	Noun	1 year ago	
helfen	Verb	1 year ago	
Türke	Noun	1 year ago	
Auto	Noun	1 year ago	
Wohnung	Noun	1 year ago	
Familie	Noun	1 year ago	
Gruppe	Noun	1 year ago	
kostet	Verb	1 year ago	
beginnt	Verb	1 year ago	
beginne	Verb	1 year ago	
nichts	Determiner	1 year ago	
Fans	Noun	1 year ago	
Nachbar	Noun	1 year ago	
Knopf	Noun	1 year ago	
laufe	Verb	1 year ago	
helft	Verb	1 year ago	
Enkelin	Noun	1 year ago	
Tasche	Noun	1 year ago	
Taschen	Noun	1 year ago	
Fische	Noun	1 year ago	
lernt	Verb	1 year ago	
Wind	Noun	1 year ago	
Biene	Noun	1 year ago	
Schuhe	Noun	1 year ago	
helfe	Verb	1 year ago	
Öl	Noun	1 year ago	
bringt	Verb	1 year ago	
hört	Verb	1 year ago	
Gemüse	Noun	1 year ago	
Brüste	Noun	1 year ago	
drücken	Verb	1 year ago	
Rücken	Noun	1 year ago	
Magen	Noun	1 year ago	
Schulter	Noun	1 year ago	
Mund	Noun	1 year ago	
ihrem	Pronoun	1 year ago	
Hand	Noun	1 year ago	
Zeitungen	Noun	1 year ago	
Zahn	Noun	1 year ago	
passt	Verb	1 year ago	
Suppe	Noun	1 year ago	
unsere	Pronoun	1 year ago	
seinen	Pronoun	1 year ago	
diesem	Pronoun	1 year ago	
fallen	Verb	1 year ago	
kaufe	Verb	1 year ago	
Jacke	Noun	1 year ago	
Körper	Noun	1 year ago	
wer	Pronoun	1 year ago	
welchem	Determiner	1 year ago	
deinem	Pronoun	1 year ago	
gehört	Verb	1 year ago	
Urenkel	Noun	1 year ago	
Cousinen	Noun	1 year ago	
folgst	Verb	1 year ago	
danke	Verb	1 year ago	
sagst	Verb	1 year ago	
Urgroßmutter	Noun	1 year ago	
Zwillinge	Noun	1 year ago	
Halbschwester	Noun	1 year ago	
Halbbruder	Noun	1 year ago	
Fragen	Noun	1 year ago	
sage	Verb	1 year ago	
Trinkgeld	Noun	1 year ago	
Verwandte	Noun	1 year ago	
Nichten	Noun	1 year ago	
Neffen	Noun	1 year ago	
geben	Verb	1 year ago	
gebe	Verb	1 year ago	
Freundin	Noun	1 year ago	
Frage	Noun	1 year ago	
Oma	Noun	1 year ago	
gibt	Verb	1 year ago	
ihre	Pronoun	1 year ago	
was	Pronoun	1 year ago	
jede	Determiner	1 year ago	
sehen	Verb	1 year ago	
sagen	Verb	1 year ago	
zeigen	Verb	1 year ago	
viele	Determiner	1 year ago	
dies	Pronoun	1 year ago	
sieht	Verb	1 year ago	
Nachtisch	Noun	1 year ago	
jeder	Determiner	1 year ago	
Abendessen	Noun	1 year ago	
Kleider	Noun	1 year ago	
Kleid	Noun	1 year ago	
Teppich	Noun	1 year ago	
Pilze	Noun	1 year ago	
Zaun	Noun	1 year ago	
frühstückst	Verb	1 year ago	
Hemden	Noun	1 year ago	
Bank	Noun	1 year ago	
Hähnchen	Noun	1 year ago	
Getränk	Noun	1 year ago	
Knoblauch	Noun	1 year ago	
Hauptgericht	Noun	1 year ago	
Sohn	Noun	1 year ago	
Honig	Noun	1 year ago	
koche	Verb	1 year ago	
Natur	Noun	1 year ago	
kennt	Verb	1 year ago	
Tomate	Noun	1 year ago	
laufen	Verb	1 year ago	
Kosmetik	Noun	1 year ago	
Freund	Noun	1 year ago	
Eier	Noun	1 year ago	
Orangen	Noun	1 year ago	
lerne	Verb	1 year ago	
Möbel	Noun	1 year ago	
Hunde	Noun	1 year ago	
Schuh	Noun	1 year ago	
Kartoffel	Noun	1 year ago	
antwortest	Verb	1 year ago	
Mitglied	Noun	1 year ago	
höre	Verb	1 year ago	
Tomaten	Noun	1 year ago	
Orange	Noun	1 year ago	
spricht	Verb	1 year ago	
sein	Pronoun	1 year ago	
komme	Verb	1 year ago	
Haustier	Noun	1 year ago	
denke	Verb	1 year ago	
bezahlt	Verb	1 year ago	
Schulen	Noun	1 year ago	
Schule	Noun	1 year ago	
Beziehung	Noun	1 year ago	
wen	Pronoun	1 year ago	
Person	Noun	1 year ago	
entlang		1 year ago	
Antwort	Noun	1 year ago	
Großvater	Noun	1 year ago	
Frühstück	Noun	1 year ago	
frühstücke	Verb	1 year ago	
schmeckt	Verb	1 year ago	
Opa	Noun	1 year ago	
antworten	Verb	1 year ago	
andere	Determiner	1 year ago	
Partner	Noun	1 year ago	
Vater	Noun	1 year ago	
diese	Pronoun	1 year ago	
Mitglieder	Noun	1 year ago	
Geschlecht	Noun	1 year ago	
Vegetarier	Noun	1 year ago	
Babys	Noun	1 year ago	
jedes	Determiner	1 year ago	
anderes	Determiner	1 year ago	
seht	Verb	1 year ago	
Balkon	Noun	1 year ago	
Schlafzimmer	Noun	1 year ago	
Mantel	Noun	1 year ago	
Katze	Noun	1 year ago	
Keller	Noun	1 year ago	
Insekt	Noun	1 year ago	
Käse	Noun	1 year ago	
Kuh	Noun	1 year ago	
sprechen	Verb	1 year ago	
spielt	Verb	1 year ago	
Tür	Noun	1 year ago	
Tee	Noun	1 year ago	
versteht	Verb	1 year ago	
bauen	Verb	1 year ago	
schlafen	Verb	1 year ago	
Hosen	Noun	1 year ago	
läuft	Verb	1 year ago	
eure	Pronoun	1 year ago	
Orangensaft	Noun	1 year ago	
Reis	Noun	1 year ago	
magst	Verb	1 year ago	
mag	Verb	1 year ago	
Schokolade	Noun	1 year ago	
spreche	Verb	1 year ago	
verstehe	Verb	1 year ago	
Apfel	Noun	1 year ago	
Stühle	Noun	1 year ago	
Bett	Noun	1 year ago	
manche	Determiner	1 year ago	
liest	Verb	1 year ago	
lese	Verb	1 year ago	
Vogel	Noun	1 year ago	
Hotel	Noun	1 year ago	
Entschuldigung	Noun	1 year ago	
Kartoffeln	Noun	1 year ago	
trage	Verb	1 year ago	
Fliege	Noun	1 year ago	
Hüte	Noun	1 year ago	
Schloss	Noun	1 year ago	
Gebäude	Noun	1 year ago	
rennt	Verb	1 year ago	
fällt	Verb	1 year ago	
unser	Pronoun	1 year ago	
Fleisch	Noun	1 year ago	
verstehen	Verb	1 year ago	
Jacken	Noun	1 year ago	
spielen	Verb	1 year ago	
leben	Verb	1 year ago	
Katzen	Noun	1 year ago	
Bäume	Noun	1 year ago	
Berg	Noun	1 year ago	
brauchen	Verb	1 year ago	
lernst	Verb	1 year ago	
Röcke	Noun	1 year ago	
Wein	Noun	1 year ago	
wäscht	Verb	1 year ago	
lesen	Verb	1 year ago	
lest	Verb	1 year ago	
Mäntel	Noun	1 year ago	
Tiere	Noun	1 year ago	
Apfelsaft	Noun	1 year ago	
Kaffee	Noun	1 year ago	
Erdbeere	Noun	1 year ago	
Ente	Noun	1 year ago	
verstehst	Verb	1 year ago	
kommst	Verb	1 year ago	
kommen	Verb	1 year ago	
heißt	Verb	1 year ago	
